.........................
.........................
..........####...........
.......####.####.........
......##.......##........
......#.........#........
......##.......##........
.......#.......#.........
.......#.......#.........
.......#.......#.........
.......###...###.........
.........................
.........................
.........................
.........................
.........................
.........................
.........................
.........................
.........................
.........................
.........................
.........................
.........................
.........................
