	char tilesBase[ROWS][COLUMNS] = {
	{'.','.','.','#','.','.','.','.','.','.','.','.','.','.','.','.','.','.','.','.','.','.','.','.','.'},
	{'.','.','.','#','.','.','.','.','.','.','.','.','.','.','.','.','.','.','.','.','.','.','.','.','.'},
	{'.','.','.','#','.','.','.','.','.','.','.','.','.','.','.','.','.','.','.','.','.','.','.','.','.'},
	{'.','.','.','#','#','#','#','#','.','.','.','.','.','.','.','.','.','.','.','.','.','.','.','.','.'},
	{'.','.','.','.','.','.','.','#','.','.','.','.','.','.','.','.','.','.','.','.','.','.','.','.','.'},
	{'.','.','.','#','.','.','.','#','.','.','.','.','.','.','.','.','.','.','.','.','.','.','.','.','.'},
	{'.','.','.','#','.','.','.','#','.','.','.','.','.','.','.','.','.','.','.','.','.','.','.','.','.'},
	{'.','.','.','#','.','.','.','#','.','.','.','.','.','.','.','.','.','.','.','.','.','.','.','.','.'},
	{'.','.','.','#','#','#','#','#','.','.','.','.','.','.','.','.','.','.','.','.','.','.','.','.','.'},
	{'.','.','.','.','.','.','.','.','.','.','.','.','.','.','.','.','.','.','.','.','.','.','.','.','.'},
	{'.','.','.','.','.','.','.','.','.','.','.','.','.','.','.','.','.','.','.','.','.','.','.','.','.'},
	{'.','.','.','.','.','.','.','.','.','.','.','.','.','.','.','.','.','.','.','.','.','.','.','.','.'},
	{'.','.','.','.','.','.','.','.','.','.','.','.','.','.','.','.','.','.','.','.','.','.','.','.','.'},
	{'.','.','.','.','.','.','.','.','.','.','.','.','.','.','.','.','.','.','.','.','.','.','.','.','.'},
	{'.','.','.','.','.','.','.','.','.','.','.','.','.','.','.','.','.','.','.','.','.','.','.','.','.'},
	{'.','.','.','.','.','.','.','.','.','.','.','.','.','.','.','.','.','.','.','.','.','.','.','.','.'},
	{'.','.','.','.','.','.','.','.','.','.','.','.','.','.','.','.','.','.','.','.','.','.','.','.','.'},
	{'.','.','.','.','.','.','.','.','.','.','.','.','.','.','.','.','.','.','.','.','.','.','.','.','.'},
	{'.','.','.','.','.','.','.','.','.','.','.','.','.','.','.','.','.','.','.','.','.','.','.','.','.'},
	{'.','.','.','.','.','.','.','.','.','.','.','.','.','.','.','.','.','.','.','.','.','.','.','.','.'},
	{'.','.','.','.','.','.','.','.','.','.','.','.','.','.','.','.','.','.','.','.','.','.','.','.','.'},
	{'.','.','.','.','.','.','.','.','.','.','.','.','.','.','.','.','.','.','.','.','.','.','.','.','.'},
	{'.','.','.','.','.','.','.','.','.','.','.','.','.','.','.','.','.','.','.','.','.','.','.','.','.'},
	{'.','.','.','.','.','.','.','.','.','.','.','.','.','.','.','.','.','.','.','.','.','.','.','.','.'},
	{'.','.','.','.','.','.','.','.','.','.','.','.','.','.','.','.','.','.','.','.','.','.','.','.','.'}
	};